###############################
S.#.................#.........#
#..##.###############.#####.#.#
#...#.....#.....#.....#.#...#.#
###..##.#.#.###.#.#####.#.#####
#.#.....#.#...#...#.....#.....#
#.###.###.#.#####.#####.#####.#
#...#...#...#...#.......#.....#
#.#####.#####.#.#########.###.#
#.....#.....#.#.#.........#...#
#.###.#####.#.#.#.#########.###
#...#.....#...#.#.........#...#
#########.#####.#######.#.#####
#.......#.....#.......#.#.....#
#.#####.#.###########.#.#####.#
#.#...#.#.#.........#.#.#.....#
#.#.###.#.#.#.#######.###.#####
#.#.....#...#.......#...#.....#
#.#####.###########.###.#####.#
#.....#.#...#.........#.......#
#.###.#.#.#.#.#######.#######.#
#.#...#...#.#...#.......#.#...#
###.#######.###.#######.#.#.###
#...#...#.......#...#.....#.#.#
#.###.#.#########.#.#######.#.#
#.#...#.#...#.....#.....#...#.#
#.#.###.#.#.#.#########.#.###.#
#.#.#...#.#...#.........#.#...#
#.#.#.###.#####.#########.###.#
#...#.........#...............E
###############################